abhesion	абгезия, разделение
abhesive	абгезивное средство, разделитель
abhesive paper	неслипаемая бумага
ablation mask layer	вымывной слой-маска
abnormality control	контроль аномальных явлений
abrade	истирать
abrading agent	абразив
abrasion	шлифовка
abrasion resistance	сопротивление истиранию
abrasion resistant	износоустойчивый
abrasive	абразив
absorbability, absorbency, absortive capacity	абсорбционная способность
absorbent	абсорбент
absorption	абсорбирование
accelerated ageing	ускоренное старение
accelerated storage test	ускоренное испытание на хранение
acceleration	ускорение
accept	выход
accept discharge	выход чистой массы
acceptance	приемка
accepted chips	отсортированная щепа
accepted stock, accepts	отсортированная масса
accordion fold, accordion pleat	укладка гармошкой
achromatic selection of color	ахроматический синтез цветов
acid 	кислотный
acid size 	высокосмоляной клей
acid-free 	безкислотный
acoustic enclosure 	звукоизолирующая кабина
across the fibre	поперек волокон
action flow 	мероприятия
activate 	активизировать
active ionization 	активная ионизация
actuate 	вводить в эксплуатацию
actuating switch	пусковое устройство
adaptive-control system	адаптивная система управления
add files 	добавленные файлы
additional air 	добавочный воздух
additional load 	добавочная нагрузка
additives 	добавки
adherence 	клеящая способность
adhesion 	адгезия
adhesion strength	прочность клеевого соединения
adhesive	клей, адгезионный слой
adhesive and anti-halation layer	адгезионный и противоореольный слой
adhesive applicator 	узел нанесения клея
adhesive formulation 	состав клея
adhesive joint 	клеевое соединение
adhesive mechanism 	клеевой узел
adhesive saver 	восстановитель
adhesive trap	липкая система улавливания пыли
adhesives	добавки для мокрой части
adhessive contamination trap	липкая система улавливания пыли
adjustable gap	регулируемый зазор
adjusting screw	регулировочный винт
advance notification	предварительное уведомление
afforestation 	облесение
after-shrinkage 	дополнительная усадка
after-treatment 	последующая обработка
ageing resistance 	сопротивление старению
ageing test 	испытание на старение
agitation 	перемешивание
agitator	мешалка
air 	воздух
airbag 	воздушный мешок
air conditioner	установка для климатизации
air conveyors	пневматические транспортеры
air cooling	охлаждение воздухом
air cushion	воздушная подушка
air cylinder	пневмоцилиндр
air distributor pipe	распределительный воздуховод
air dryer	сушка воздухом
air filter	воздушный фильтр
air heater	нагреватель воздуха
air impermeability	воздухонепроницаемость
air in	воздух внутри
air intake	подача воздуха
air jet	воздушное сопло
air loading system	воздушная сиситема нагрузки
air make-up	приточная вентиляционная установка
air nozzle	воздушное сопло
air permeability	воздухопроницаемость
air permeability/porosity meter	прибор для определения воздухопроницаемости/ пористости
air permeability test	испытание на воздухопроницаемость
air pocket	воздушный карман
air pollution	загрязнение воздуха
air preheater	воздухоподогреватель
air relief	удаление воздуха
air return system	система рециркуляции воздуха
air supply	подача воздуха
air tube	воздуховод
air valve	воздушный клапан
air vent	воздуховыпускной (воздушный) клапан
air-actuated	управляемый воздухом
air-blade coater	меловальный станок с воздушным шабером
air-dried	высушенный на воздухе
air-impingement dryer	сопловая сушилка
airlock	воздушная разделительная камера
airproof	воздухонепроницаемый
airtight discharge valve	герметичный спускной вентиль
albatron mask layer	адгезионный слой
align	выравнивать (синхронизировать), «элайнить»
aligned sheet	отцентрованный лист
alignment	выравнивание, синхронизация, «элайнмент»
alignment element	приводочная метка
alignment station	станция центрирования
alkali	щелочь
alkali ratio	соотношение активных щелочей в щелоке
alkali-free	не содержащий щелочи
alkaline	щелочной
along the fibre	вдоль волокон
alpha	альфа
alpha and omega of corrugated board	альфа и омега гофрокартона
alpha-cellulose	альфа-целлюлоза
alpha-pulp	целлюлоза с высоким содержанием альфа-целлолозы
alternating impact test	испытание на циклический удар
aluminium profile	алюминиевый профиль
AM/FM hybrid	АМ/ЧМ гибридное растрирование (сочетание частотной и амплитудной модуляций)
amines	амины
amplitude modulation (AM) screening	амплитудно-модулированное (AM) растрирование
analogue	аналоговый
analyser	анализатор
analysis	анализ
anatomy of a barcode	структура штрихкода
angle and shapes of cells	угол и формы ячеек
angular correction	угловая коррекция
aniline printing	анилиновая печать
anilox roll	анилоксовый (растровый) вал
anti-foaming agent	противопенная добавка
antiskid	противоскользящий

baby dryer	предварительный сушильный цилиндр
back current	обратный ток
back face	невидимая поверхность
back pressure relief valve	спускной клапан избыточного давления
back water	оборотная вода
backing layer	оборотная сторона пластины
backing sheet	подложка, пленка, основа
hackstand	стойка для рулонов
backstop	задний упор, ограничитель обратного хода
back-up roll	опорный вал
bactericides	бактерициды
baffle blades	лопасти-отражатели
baffler plate	отражающая пластина
bag	мешок
bailer	упаковочный пресс
bale 	кипа (бумаги)
bale opener, bale plucker 	кипоразбиватель
bale pusher	толкатель кип
bale strapping	обвязка тары
bale weigh station 	станция для взвешивания кип
baling 	упаковка в кипы
baling press	упаковочный пресс
baling wire 	вязальная проволока (для кип)
ball valve 	шаровый клапан
bamboo frame	рама из бамбука
banding	полошение
banding station	станция обвязки
barcoding system 	система штрихкодирования
barcode 	штрихкод
barcode label printer 	принтер для печати этикетки со штрихкодом
barcode scanner 	сканер штрихкода
barcoding system staff 	составляющие системы штрихкодирования
barker 	окорочная машина
bars 	лопасти
base 	основа
base film 	подложка
base paper 	бумага-основа
base ply 	основной слой
based liner 	основной тестлайнер
baseline 	базовая линия
basis weight balancer 	устройство для определения плотности бумаги
beacon 	сигнальное устройство
beam	балка, траверса
bellows steam trap 	сильфонный конденсатоотводчик
belt 	сукно, сетка
belt drive drums 	барабан привода сукон
belt drive wheel 	шкив привода сетки
belt regulator 	регулятор хода сукна
belt roll 	ременной шкив
belt shaker	устройство для встряхивания полотна
belt for corrugator 	сукно для гофроагрегата
bend 	сгибать
bend (bending) quality 	гибкость
bend test 	испытание на изгиб
bending angle	угол изгиба
bending chipboard	упругий макулатурный картон для складных коробок
bending fatigue test 	испытание на длительное сопротивление изгибу
bending fatigue tester 	прибор для испытания на длительное сопротивление изгибу
bending force 	сила изгиба
bending moment	момент изгиба
bending resistance	сопротивление изгибу
bending stiffness	несгибаемость, сопротивеление изгибу
bending test	испытание на изгиб
Bendtsen roughness number	 показатель шероховатости по Бендтсену
best match, exact match 	полное совпадение
bills of materials	спецификации продукции
bio-blanching	биоотбеливание
biodegradability	биоразлагаемость
biomass 	биомасса
bit depth, color depth	глубина цвета
bitmap	битовая карта
black 	черный
black mask 	черная маска
black mask layer 	черный слой-маска
black point 	точка черного (подвижная относительная точка, определяющая самые темные участки изображения, по которым регулируются все остальные части изображения в области теней)
blackening	эффект почернения
blade	ракель
blade coating	шаберное мелование
blade bending machine	автомат для гибки ножей
blades fixing	забивка ножей в фанерное основание
blade holder	шаберодержатель
blades lock	сцепление ножей
blank	заготовка
blank separating	разделение заготовки
blanket	офсетное полотно, офсетная резина
blanket cylinder	резинотканевый вал
blast gate	вентиляционная заслонка
bleached	беленый
bleached (TCF) eucalyptus kraft pulp fibres	беленая целлюлоза из эвкалиптовых пород древесины
bleached pulp	беленая масса
bleaching	отбелка
bleacher	аппарат для отбеливания
bleaching agent	отбеливающее средство
bleaching chest	белильный бак
bleaching of wood pulp	отбелка целлюлозы
bleaching stage	степень отбелки
blend	переход одного цвета в другой
blind spot	непропечатка
blistering	вспучивание (пузырение)
block flange	заглушка
blockage	залипание
blocking out	выкрывание нежелательных участков рисунка клише
blow tank	продувной бассейн
blower	воздуходувка, нагнетательный вентилятор
blower outlet	нагнетательный вентилятор выход
blowing nozzle	продувочное отверстие
blowing-out	выдувание
blowthroug line	продувная линия
board caliper	толщина картона
board cutting	картонная заготовка
board mill	картонная фабрика
board travel	направление движения картона
board type	марка картона
bobbin	бобина
boiler	котел
boiler feed line	линия питания котла
boiler feed pumps	питающие насосы котла
boiler feed water	питающая вода для котла
boiler level gauges	датчик измерения уровня котла
boiling apparatus	варочный аппарат
bonding	сцепление
bonding process	процесс склеивания
bonding strength	прочность сцепления
bone-dry solids	абсолютно сухое вещество
borax	бура
bottom auto feeder for large size	нижний загрузчик на большие форматы
bottom belt	нижнее сукно (лента)
bottom corrugating roll	нижний вал для гофрирования
bottom cylinder felt	нижнее сукно цилиндра
bottom felt	нижнее сукно
bottom fluter	нижний вал для гофрирования
bottom ply	нижний слой
bottom prefeeder operation mode	принцип работы префидера с нижней загрузкой
bottom printing	печать снизу, нижняя печать
bottom sheet insertion robot	робот для укладки нижнего листа
bottom sheet feeder	машина для подачи нижнего листа
bottom sheetfeeding	загрузка нижнего листа
box board	коробочный картон
box plant	завод гофротары, цех по выпуску гофроящиков
boxmaker	производитель гофротары
brake	тормоз
brake bar	тормозная планка
braking of the old web	торможение старого полотна
break	разрыв
breakdown	дефект
breakdown maintenance	ремонт вышедшего из строя оборудования
breaker	разламыватель
breaker beater	разбивной (распускной) ролл
breaker fan	вентилятор-разрыватель
breaker stack	мокрый (полусухой) каландр
breaking	разламывание
breaking (strength) tester	разрывная машина
breaking force	разрывное усилие
breaking length	разрывная длина
breaking of primary wall	разрыв первичной оболочки
breaking strength (strain, resistance)	сопротивление разрыву
breast roller	грудной вал
bridge	накопительный мост, перемычка, консоль
bridge brake	тормоз моста
bridge conveyor	транспортер накопительного стола
bridge guide	направляющая моста
brightness	глянец
briquette machine	машина для брикетирования
broke	брак
brown kraftliner	бурый крафтлайнер
brown liner	бурый лайнер
brown testliner	бурый тестлайнер
brush	щетка
brush web cleaning technology	технология удаления пыли с бумажного полотна при помощи щетки
bucket wheel	черпальное (вращающееся) колесо
buffer conveyor	накопительный транспортер
buffer storage	промежуточный склад
building and works department 	отдел капитального строительства
building earthing	заземление здания
built-in format	встроенный формат
bulk	пухлость
bunch	пучок
bunch forming unit 	узел формирования пачки
bundle 	пачка
bundle breaker (bundle separator)	разделитель пачки (разламыватель)
bundling unit 	узел формирования пачки
burst factor (index, ratio) 	показатель сопротивления продавливанию
burst test	испытание на продавливание
burst tester 	прибор для измерения сопротивления продавливанию
bursting area 	поверхность продавливания
bursting strength 	прочность на разрыв, сопротивление продавливанию
bursting strength test (BST) 	испытание на сопротивление продавливанию
bursting tensile 	предел прочности при растяжении
busbar bridge 	шинный мост
butt splicing 	склеивание встык, стыковое сплайсирование
bypass channel 	обходной канал

cabinet 	шкаф управления
cake 	папка
calendering 	каландрирование
calender section 	каландр
calender 	отделочная секция, каландр
calender rollers 	каландровые валы
calendered jumbo roll	материнский рулон (тамбур) после каландрирования
calendered paper	каландрированная бумага
calendering unit	узел каландрирования
calibrating unit	узел выравнивания
caliper loss	задавливание профиля гофры
capacity	производительность
capacity management	управление мощностями
capital equipment	основное оборудование
capsule steam trap	капсульный конденсатоотводчик
cardboard	картон
cardboard feeder	загрузчик картона
carriage	тележка
carriage with tool head	каретка с режущей головкой инструмента
carrying roll	несущий вал (ролик)
carton blank	заготовка складной коробки
cartridge	кассета
cartridge collector	пылеуловитель картриджного типа
cartridge filter	фильтр картриджного типа
cartridge type single facer	гофропресс кассетного типа
casemaker	машина для производства ящиков
catalitic filter cloth	каталитическое фильтровальное полотно
catalyst support surface	поверхность подложки катализатора
cationic starch	модифицированный крахмал
causion	предупреждение
caustic unit	станция каустической соды
cell	ячейка
cell's wall	стенка ячейки
cellulose	целлюлоза
cellulose activation (activation of cellulose)	активация целлюлозы
cellulose depolymerizing (depolymerizing of cellulose)	деполимеризация целлюлозы
cellulose destruction (destruction of cellulose)	деструкция целлюлозы
cellulose fibre	целлюлозное волокно
cellulose fibre paper	бумага из целлюлозного волокна
centerline	осевая линия
central impression cylinder	центральный прижимной вал
central roll	центральный вал
central stripping pull out frame with quick locking	выдвижная рама для центральной части оснастки для удаления отходов с системой быстрой блокировки
central stripping pull out  frame	выдвижная рама для центральной части оснастки для удаления отходов
centricleaner, centrifugal cleaner	центриклинер
centrifugal fan 	центробежный вентилятор
centrifugal finer 	центрифайнер
centrifugal pump 	центробежный насос
centrifugal screen 	центрискрин
chain 	цепь
chain conveyor	цепной транспортер
chain pallet conveyor	цепной транспортер для транспортировки поддонов
chain tension unit	устройство натяжения цепи
chain transfer conveyor	цепной передаточный транспортер
chamber	камера
chambered doctor blade	ракельная камера
chambered doctor blade ink metering system	система подачи краски с ракельной камерой
chambered doctor blade inking	ракельный красочный аппарат
change approval	утверждение изменений
change control system	система контроля над изменениями
change plan	план изменений
character map	таблица символов
chase 	заключная рама
chassis 	ходовая часть
check	проверка
checkdigit 	контрольный символ
check valve 	запорный клапан
chemical 	химикаты
chemical characteristics	химические свойства
chemical recovery and regeneration	система восстановления химикатов
chip	щепа
chip screen	сортировка щепы
chipboard	низкосортный макулатурный картон
chipper	дробильная машина
chopper fan 	вентилятор-разрыватель
chopperline 	система измельчения
chuck 	зажимной патрон
chute 	загрузочный желоб
chute-type machine	машина с системой подачи ленты сверху
circular screen	цепеобразная растровая точка
circular screen (AM)	цепеобразная растровая точка (AM)
circular screen 	круглый растр
clamp 	зажим
clamp forklift 	погрузчик с захватами
clamping bar	зажимная планка
clamping cylinder 	зажимной цилиндр
clamping handle 	зажимная ручка
clay coated 	мелованная бумага
clean air 	чистый воздух
clean recycled fibres	очищенное макулатурное волокно
clean up 	очистка
cleaner 	очиститель
cleaning 	очистка
cleaning blade 	очищающий ракель
cleaning head 	пылеудаляющая головка
cleaning head lifter	подъемное устройство пылеудаляющей головки
cleaning module	узел очистки
cleaning the sheet 	удаление пыли с листа
cleavage 	расслаивание
climb angle of board 	угол подъема картона
clipping 	отсечение
close register	точная приводка, точное совмещение (красок)
closed cells	ячейки закрытого типа
closed faced double sided  tape	двухстороння лента на клапан коробки для закрывания
closed loop steam and condensate system	кольцевая пароконденсатная система
closed system	система закрытого типа
dosed-cyde mill	завод (фабрика) с замкнутым циклом (с замкнутой системой)
closing tape	лента для закрывания
cloud service	облачное хранилище данных
CMM (Color Matching Metod)	алгоритм цветовых преобразований
CMS (Color Management System)	система управления цветом
CMYK (cyan-magenta-yellow-black)	четырехцветная автотипия CMYK (голубой, пурпурный, желтый, черный)
coagulating agent 	коагулянт
coalescence solvent 	связующий растворитель
coarse boards 	грубые сорта картона
coarse flute 	крупный профиль
coarse screening 	грубое сортирование
coatability	способность к нанесению покрытия (к крашению, к мелованию)
coater 	меловальная установка
coater head 	меловальная головка
coating 	нанос, мелование
coating head with profiled bar	наносная головка с профильной планкой
coating kitchen	меловальная кухня
coating slurry apply	нанесение меловального слоя
coating unit	узел нанесения верхнего слоя, покрытия
Cobb test	тест Кобба
cold corrugating process	процесс холодного гофрирования
cold corrugator	холодный гофроагрегат
color gamut	цветовой охват, гамма цветов
color model	способ представления информации о цвете в цифровых данных
color primaries	основные цвета
color register	приводка
color rendering	цветовоспроизведение, цветопередача
color sample card 	карта эталонных оттенков
color separation 	цветоделение
color space 	цветовое пространство
colorimeter 	колориметр
color filter 	цветной светофильтр
color processing 	обработка цвета
color range chart 	цветовая палитра
color registration 	совмещение цветов
color separation 	цветоделение
color sequence	последовательность цветов
color-fast 	цветостойкий
coloring material 	краситель
colorless 	бесцветный
column test	испытание на сопротивление продольному изгибу кромки (гофрированного картона)
combination board	многослойный (разнослойный) картон
combination chipboard	многослойный макулатурный картон
combination of amplitude and frequency modulation (AM/FM).	сочетание амплитудной и частотной модуляций (АМ/ЧМ)
combination profile	комбинированный профиль
combined board 	комбинированный картон
combined dryers 	комбинированные сушки
combining rolls 	соединительные валы
commercial method 	промышленный способ
compacting tunnel with ram	тунель для прессования с поршнем
compactor 	компактор
compare 	сравнение
compartment 	камера
compensating basin 	буферный бассейн
compensation curve 	компенсационная кривая
complex production line designed to produce different grades of paper or board	комплексная производственная линия, спроектированная для  производства различных марок бумаги или картона
composite container 	комбинированная тара
composition 	композиция
compressible foam 	демпферная лента
compression 	сжатие (данных)
compression ratio 	степень сжатия
compression resistance (strength)	сопротивление сжатию
compression strain	деформация при сжатии
compression strapper	обжимной обандероливатель
compression strength	прочность на сжатие
compression test	испытание на сжатие (на раздавливание)
compressive force 	усилие сжатия
compressor 	компрессор
computer 	компьютер
computer-to-plate	вывод изображения с компьютера непосредственно на формную пластину
concept proof	концептный оттиск
Concora medium test	испытание гофрированного слоя картона на плоскостное сжатие прибором Конкора
concordance search	поиск соответствий
condensate	конденсат
condensate and blow through steam	конденсат и продувной пар
condensate discharge 	выход конденсата
condensate from facers 	конденсат с гофропрессов
condensate inlet 	вход конденсата
condensate receiver	конденсатосборник
condensate return water	возврат конденсата
condensed font	сжатый шрифт
condenser	конденсатор
condition based maintenance	техническое обслуживание в зависимости от состояния оборудования
cone	конус
conical refiner 	мельница коническая
connection 	подключение
consistency controller 	регулятор концентрации
console 	пульт управления
consumables 	расходные материалы
consumer package	потребительская упаковка (тара)
consumer product company	компания по производству потребительских товаров
consumption 	потребление энергии
consumption measurement 	снятие показаний расхода чего либо
contact cleaning brush	контактная щетка для удаления пыли
contact drying 	контактная сушка
contact head 	головка контактного типа
contaminants	отходы, посторонние вещества
continuous purge vent 	продувной вентиль
continuous-tone image, tone art	полутоновое изображение
continuous-tone step scale	ступенчатая полутоновая шкала
contour-type font 	контурный шрифт
contra flow cylinder vat with top cylinder felt	ванна цилиндра с потоком в противоположном направлениие с верхним сукном цилиндра
contract proof 	контрактный оттиск
contraction	усадка
contractor 	подрядчик
contrast 	контрастность
control box	пульт управления, распределительная коробка
control cabinet 	шкаф управления
control center 	центр управления
control damper 	регулирующий клапан
control nozzle 	контрольный штуцер
control of glue application	система контроля нанесения клея
control panel 	панель управления
control system 	система управления
control unit	блок управления, устройство управления
control valve 	регулирующий клапан
convection dryer 	конвекционная сушилка
conventional 	традиционный
conventional camera 	традиционная камера
conventional corrugating roll	традиционный гофровал
conventional printing plate	аналоговая печатная форма
conventional system	традиционная система
conventional transfer car	традиционная передаточная тележка
conversion 	переработка
converter 	преобразователь
converting area 	зона переработки
converting equipment	перерабатывающее оборудование
converting line 	перерабатывающая линия
converting machine	перерабатывающая машина
converting machinery	оборудование для переработки (бумаги, картона)
converting machines in- and outfeed	загрузка на и вывод с перерабатывающих линий
converting mill 	перерабатывающий завод
conveting zone 	зона переработки
conveyor	транспортер
conveyor belt and rear evener	ленточный транспортер и задний выравниватель
conveyor fan	транспортирующий вентилятор
conveyor pipeline	транспортирующий трубопровод
conveyor system 	конвейерная система
conveyor's drive 	привод транспортера
conveying air 	транспортирующий воздух
cooking chemicals 	химикаты для варки
cooling section 	охладительная секция
cooling water 	охлаждающая вода
cooling air and ozone exhaust	выход охлажденного водуха и озона
copy preparation (copy prep, manuscript reading)	вычитка
core 	гильза
core return line 	линия возврата гильз
core-screening 	штифт
corona treatment	обработка коронным разрядом
corona wire	проволочный коронирующий электрод
corrective maintenance	восстановительное техническое обслуживание
corrosion 	коррозия
corrugated (flat) crush test	испытание гофрированного картона на продольный изгиб
corrugated board 	гофрированный картон
corrugated board market 	рынок гофротары
corrugated board sizing machine	узел для склеивания  гофрокартона
corrugated box 	гофроящик
corrugated case 	гофротара
corrugated case material (CCM)	макулатурное сырье из вторичного волокна
corrugated industry 	гофроиндустрия
corrugated packaging	гофрированная упаковка, гофротара
corrugated paper 	гофрированная бумага
corrugated plant 	гофрозавод
corrugated tray 	гофрированный лоток
corrugating adhesive	клей для склеивания гофрированного картона
corrugating medium test (CMT)	испытание гофрированного образца
corrugating roll 	гофровал
corrugation coefficient	коэффициент гофрирования
corrugator 	гофроагрегат
corrugator fan	вентилятор на гофроагрегате
corrugator hot plate section flow scheme	технологическая схема секции нагревательных плит гофроагрегата
corrugator outfeed 	вывод с гофроагрегата
corrugator slitter section	секция продольной резки на гофроагрегате
corrugator trim	кромка с гофроагрегата
corrugator zone 	зона гофроагрегата
cost effective 	рентабельный
cost measurement 	оценка затрат
costings 	смета расходов
cotton rag 	хлопковая ветошь
couch roll (roller) 	гауч-вал
counter pressure	печатный (прижимной) вал
counter-adhesion 	кэширование
counter-ejector	счетно-выводное устройство, счетчик-укладчик
countermeasure	профилактические мероприятия
counter-pressure cylinder	печатный (прижимной) вал
counting and stacking unit 	счетчик-укладчик
counting unit 	счетчик-укладчик
cover 	поверхностная пластина
cover film 	защитная пленка
covered steel roll	вал со стальным покрытием
cracking 	растрескивания
crashlock	сборка ящика сложной конструкции со складным дном
crease resistance	сопротивление фальцеванию (бигованию, рифлению)
creasing 	фальцовка
create job 	создание работы
creation of fines	получение мелких фракций
crimp 	гофрировать
crimper 	обжимное устройство
cropping	обрезка, кадрировка
cross-axial breaker 	поперечный разделитель
cross cutting 	поперечная резка
cross direction 	поперечное направление
cross direction profile 	поперечный профиль
cross-cutting knife drum 	ножевой вал саморезки
cross-flute turner	устройство для разворота поперечного профиля гофрирования
cross-switch	перекрестный переключатель
crow's feet 	морщинистость
crush test 	тест на раздавливание
CTP (computer-to-plate)	с компьютера на печатную форму
CTP output equipment	оборудование для передачи изображения с компьютера на форму
cup cell	ячейка
curing 	созревание (вызревание)
curtain coating 	шторное мелование
cushion backing 	подложка
cushioning property 	амортизационное свойство
custom color 	чистый цвет
customer 	заказчик
customer complaint handling	обработка рекламации заказчик
customer reply confirmation	ответ заказчика подтверждение
customer relationship management (CRM)	управление связями с заказчиками (или клиентами)
customer requirement 	требования заказчика
customer support 	клиентская поддержка
cut accuracy 	точность реза
cut size 	заготовка
cut trim delivers to a separator and then to a baler	измельченная кромка направляется на сепаратор, а затем на упаковочный пресс
cut-off 	узел поперечной резки
cut-out 	вырубной штамп
cutter 	поперечная резка
cutter tray 	листоукладчик
cutter-creaser	машина для резки и фальцевания
cutter-slitter	станок для продольной и поперечной резки (для резки форматов)
cutter-sorter	поперечно-резательный станок (саморезка) с сортировкой листов
cutting and creasing die press	рилевочно-просечной пресс
cutting cylinder	высекальный цилиндр
cutting die	вырубной(пробивной) штамп
cutting head	режущая головка
cutting knife	нож для рез
cutting of fibre	рассекание волокна
cutting of the old web	обрезание старого плотна
cutting plate	высекальный штамп
cutting plotter	режущий плоттер
cutting section	секция резки
cutting shape making	сборка контура изделия в штамп
cutting to size	резка по формату
cutting to size	резка по формату
cutting unit	узел резки
cutting unit drive	привод узла резки
cyan	синий
cycling systems to conserve energy	циклическая система для сохранения энергии
cyclone	циклон
cyclone cylinder	цилиндр циклона
cyclone dust collector	пылеуловитель циклонного типа
cyclone outlet	циклон выход
cylinder	вал
cylinder board	картон с цилиндровой (круглосеточной) машины
cylinder board machine	картоноделательная круглосеточная машина
cylinder former	вакуумформер
cylinder grinder	шлифовальный станок для цилиндров
cylinder machine	круглосеточная бумагоделательная машина
cylinder mould	круглосеточный (формующий) цилиндр
cylinder vat board	картон ручного съема (ручной вычерпки)
cylindrical container	цилиндрический контейнер

damp streak 	полоса на бумаге
damper 	задвижка
damper valve 	задвижка
damper vane 	виброгаситель
damping roll 	увлажнительный валик (цилиндр)
damping stretch 	растяжение (удлинение) после увлажнения
dancer (dancing) roll 	натяжной вал
dancer arm 	плавающий рычаг для регулировки натяжения
dancer roller 	плавающий валик для регулировки натяжения
dandy roll 	ровнительный валик, эгутер
dark print color 	темный цвет печати
data collection 	сбор данных
data fed back 	обратный поток информации
data feeds 	загрузка данных
data manager 	администратор базы данных
data mining 	сбор и анализ данных
data sources 	источники данных
data warehouse 	хранилище данных
dead knife 	контрнож
dead spots 	недостаточно каландрированные (сатинированные) места
deadlock 	остановка
deaerated boiler feedwater 	деаэрированная питающая вода для котла
deaerated storage 	деаэрированное хранение
deaeration steam 	деаэрационный пар
deaerator 	деаэратор
de-ashing 	обеззоливание
debris deflector screen 	сито, отражающее отходы
debris drum 	бак с отходами
deceleration 	торможение
decision and order of the change 	принятие решение и внесение изменений в заказ
deck plate 	верхняя плита
deckenpapier (TDP) 	декенпапир (TDP)
decompression 	декомпрессия
dedicated system 	специализированная система
defect analysis	анализ дефектов
defect occurrence 	выявление дефектов
defibrator 	дефибратор
defined travel path 	заданный путь
deflaker 	дефлокулятор
deformation 	деформация
degasificator 	дегазификатор
degree of adhesion 	уровень клейкости
degree of packing 	степень уплотнения (щепы)
degree of polymerization 	степень полимеризации
degree of purity 	степень чистоты
degree of refining 	степень помола
degree of ripening 	степень зрелости
degree of saturation 	степень насыщения (пропитки)
dehydrated waste 	обезвоженные отходы
dehydration 	дегидрадация
deinked recycled fibres 	макулатурное волокно, очищенное от краски
de-inking 	деинкинг, удаление краски
de-inking schematic 	схема деинкинга
delamination 	расслоение
delamination and hydration of fibres	расслоение и гидратация волокна
delamination of cell wall 	расслоение оболочки клетки
delivery 	выход, зона транспортировки, доставка
delivery belt 	листовыводной транспортер
delivery station 	станция транспортировки
delivery table 	приемный стол
delivery to the corrugator 	доставка на гофроагрегат
densitometer 	денситометр
density 	плотность, оптическая плотность
density range 	диапазон оптических плотностей
depth of hollow 	глубина рельефа
depth of the cell 	глубина ячейки
descreening 	снятие растра
design 	дизайн
design department 	дизайнерский отдел
design quality control 	контроль качества дизайна
design review 	оценка (анализ) дизайна
despeckle 	снятие пятнистости
deterioration of paper 	старение бумаги
determining factor «К» 	коэффициент сжатия «К»
development 	разработка проекта
development flow 	последовательность этапов выпуска продукции
development of process 	разработка технологического процесса
device 	проект
device profile 	профайл
devil 	разрыватель целлюлозы
de-watering 	обезвоживание
diaphragm 	диафрагма
diaphragm valve 	мембранный клапан
dichroic mirror 	дихроическое зеркало
die 	форма
die and tool making 	изготовление штампов и оснастки
die carrying cylinder 	штампонесущий вал
die cut(ting) press 	высекальный пресс
die cut box 	высечной ящик
die cut design 	высечная конструкция
die cut sheet 	готовый формат листа
die cutter 	узел высечки, вырубной штамп
die cutting rule 	форма для вырубки (высечки)
die making	подготовка формы для вырубки (высечки)
die making department 	участок изготовления штампов, штанцевых форм
die shape 	конфигурация высечки
die shop 	участок изготовления штампов
differential pressure gauge 	дифференциальный манометр
differential spacing 	дифференцированный шаг
diffusion process 	диффузия
digester 	варочный котел (аппарат)
digital camera 	цифровая камера
digital color proof 	цифровая цветопроба
digital image 	цифровое изображение
digital ink jet printing 	цифровая струйная печать
digital offset 	цифровая офсетная печать
digital press 	цифровое печатное устройство
digital printing 	цифровая печать
digital proofing 	цифровая передача точечного изображения, цифровая пробная печать
digitalization 	цифровая обработка
dilutant 	разбавитель
dilution 	разбавление
dimensional accuracy 	точность размеров
dimensioned drawing 	масштабный чертёж, чертёж с размерами
direct flow cylinder vat with bottom cylinder felt 	ванна цилиндра с потоком в прямом направлении с нижним сукном цилиндра
direct tone 	основной цвет
direct UV-radiation 	прямое УФ-излучение
direction of print 	направление печати
direct-print (post-print) 	цифровая печать
direct-to-plate	прямое экспонирование формных пластин непосредственно по данным об изображении
direct-to-press	передача данных о печатаемом изображении непосредственно на цилиндр печатной машины
dirty air inlet	вход грязного воздуха
dirty print	грязный оттиск
dirty print color	грязный цвет печати
disc	диск
disc filter	дисковый фильтр
disc refiner	дисковый рафинер
disc screen	дисковая сортировка
disc steam trap	дисковый конденсатоотводчик
discards	отходы
discharge conveyor	выводной транспортер
discharge gas inlet	вход отработанного воздуха
discharge to waste collection method	выход на систему сбора отходов
discharge valve	спускной клапан
discolor	обесцвечивать
disconnecting device	отключающее устройство
dispense module	модуль смешивания
disperser	диспергатор
dispersing	диспергирование
dispersion	дисперсия
display system	система отображения данных
disrupted bonds	нарушение связей
distortion	деформация, удлинение
distributing roller	распределительный валик
distribution box	распределительная коробка (блок)
distribution transformer	распределительный трансформатор
diverter valve	распределительный клапан
divided press	составной пресс
division	решетка
do	реализация
doctor	шабер
doctor blade	ракель
doctor broke	шаберный брак (на прессах)
doctor marks	маркировка шабером
doctor roll	дозирующий валик
doctoring system	ракельная система
document control	контроль документооборота
dolly	тележка
dolly roller	выравнивающий вал
dosing equipment	дозировочное (дозирующее) устройство
dot area	площадь растрового элемента
dot bridging	залипание растровых точек
dot gain	растискивание
dot gain scale	шкала для контроля растискивания растровых точек
dot shape	форма растровой точки
dot spread	растискивание растровой точки
dot-chaining	сцепление растровых точек
dot-chaining screen	растр с эллиптическими цепеобразными элементами
dot-for-dot reproduction	поточечное воспроизведение
dot-in-dot printing	печать с точной приводкой, печать «точка в точку»
dot-on-dot register	точная приводка, приводка «точка в точку»
double backer	сушильно-охлаждающий стол
double bottom	двойное дно
double calendered	дважды каландрированный
double coated	дважды мелованный
double dots	сдвоенные растровые точки
double face board	трехслойный картон
double facer 	сушильно-охлаждающий стол, сушильный стол
double facer with air loading system 	сушильно-охлаждающий стол с воздушной системой нагрузки
double feather-edged 	с противоположными отшлифованными кромками
double knife machine 	двоножевая машина
double preheater 	двойной узел предварительного нагрева
double scoring profile 	система двойной биговки
double sided tape 	двухсторонняя лента
double sized 	с двухсторонней (поверхностной) проклейкой
double sizing 	двойное проклеивание
double wall corrugated board 	пятислойный гофрированный картон
double-deck (double-tier) dryers	двухъярусное расположение сушильных цилиндров
double-disc refiner 	двухдисковый рафинер
double-drum reel (reeler) 	двухбарабанный накат
double-drum winder 	двухрулонный перемотный станок
double-face linerboard 	двухслойный лайнер
double-face tape 	двухсторонняя клеющая лента
double-felted press 	двухсуконный пресс
double-fourdrinier machine 	бумагоделательная машина с двумя плоскими сетками
double-up station 	станция удваивания
double-wall box 	коробка с двойной стенкой
downstacker 	стопоукладчик с нижней загрузкой
drain 	спускной патрубок
draw factor 	коэффициент усадки
drier with warm air 	сушка сухим воздухом
drier 	сушка
drive 	привод
drive belt 	приводной ремень
drive for festoon carriage 	привод для накопительной каретки
drive for heating cylinder 	привод для подогревательного цилиндра
drive for wrap roll 	привод вала охвата
drive group 	приводная группа
drive of the chain conveyor 	привод цепного транспортера
drive of the roller conveyor 	привод роликового транспортера
drive roller 	бумаговедущий валик
drive shaft 	ведущий вал, приводной вал
drive shaft of the chain conveyor 	приводной вал цепного транспортера
drive side 	сторона привода
drive unit 	узел привода
driven elevator forks 	приводной вилочный подъемник
driven guide roll 	приводной направляющий вал
drives for the conveyor belt 	приводы для транспортеров накопительного моста
driving belt 	приводной ремень
driving drum 	приводной барабан
drop chute 	спускной желоб
drop leg 	спускная труба
drop test	испытание на падение (сбрасывание), испытание на удар
drum filter 	барабанный фильтр
drum reel 	барабанный накат
drum screen 	сортировочный барабан, цилиндрическая сетка
drum test 	испытание (тары) в ротационном барабане
drum washer 	промывной барабан
dry 	сушить
dry and post exposure 	сушка и постэкспонирование
dry curl 	коробление при сушке
dry end 	сухая часть
dry extract 	сухое вещество
dry felt 	сушильное сукно
dry particles transfer to elastomer roller	перенос сухих частиц пыли на вал с покрытием из эластомера
dry proofing 	сухой пробный оттиск
dry spinning of paper 	сухое формирование бумаги
dry steam 	сухой пар
dryer 	сушильный вал
dryer head 	боковая поверхность сушильного цилиндра
dryer screen (fabric) 	сушильная сетка
dryer section 	сушильная секция (часть)
drying agent 	осушитель, сушильный агент
drying chamber 	сушильный шкаф, сушильная камера
drying cylinder 	сушильный цилиндр, сукносушильный цилиндр
drying floor (loft) 	сушильный цех
drying kiln 	сушильная печь
drying rate 	скорость сушки
drying unit 	секция сушки
dryness 	сухость
dual arch board 	гофрированный картон с двухслойным флютингом
dual flute single facer 	двухпрофильный гофропресс
duct roll 	дукторный вал
ducting 	воздуховод
ducting system 	трубопровод
ductwork system 	канальная система
dump chest 	приемный бассейн
duplex cut-of 	дуплексная резка
duplex downstacker 	стопоукладчик дуплексного типа с нижней загрузкой
duplex glue machine 	машина для склейки дуплексного типа
duplex machine 	дуплексная машина
duplex preheater 	нагреватель дуплексного типа
duplex up- and downstacker 	стопоукладчик дуплексного типа с верхней и нижней загрузкой
durability test 	испытание на прочность (выносливость, долговечность)
dust bagging station 	секция сбора пыли в мешки
dust chute 	лоток для сбора пыли
dust collector 	пылеулавливатель
dust disposal 	утилизация пыли
dust filtration station 	участок фильтрования пыли
dust particles 	частички пыли
dust removal system 	система удаления пыли
dust removal system at converting lines 	система удаления пыли на линиях производства упаковки
dust removal system with adhesive trap	система пылеудаления способом налипания
dye sublimation 	сублимационная печать
dye sublimation printer 	сублимационный принтер
dynamic bending stiffness 	динамическая жесткость на изгиб
dynamic compression test 	испытание на прочность (усталость) давлением
dynamic endurance (fatigue) test	динамическое испытание на выносливость (усталость)
dynamic range 	динамический диапазон

earth grid 	сеть заземления
ecology 	экология
edge 	кромка
edge crush 	торцевое сжатие
edge crush resistance	показатель сопротивления раздавливания кромки
edge crush test	испытание на продольный изгиб кромки, испытание на торцевое сжатие
edge tear 	раздирание
edge tearing resistance (strength)	сопротивление раздиранию
edge trim	боковая кромка
edge trim extraction system	система удаления боковой кромки
edge warp 	коробление кромки
edge master tape 	лента для усиления края
edgewise compression test (ECT)	испытанине на торцевое сжатие
edgewise crush resistance (strength)	сопротивление раздавливанию кромок
edgewise crush resistance test	испытание на сопротивление продольному изгибу кромки (гофрированного картона)
edging 	наложение
editing 	редактирование
education 	обучение
effect of refining 	эффект расслоения
effective resolution	эффективная разрешающая способность
effluent waste	жидкие промышленные отходы
electric cabinet 	электрический шкаф
electric switchbox	распределительный ящик электросистемы
electrical pathway 	токопровод
electrically trapped particles	наэлектризованные связанные частицы
electricity	электрическая
electronic	электроника,электронный
electronic control box	электронный блок управления
electrostatic charger	электростатическое зарядное устройство
elliptical dot	растровая точка эллиптической формы
Elmendorftest	испытание на разрыв по Зльмендорфу
Elmendorf tester	прибор для испытания на разрыв по Эльмендорфу
elongation 	растяжение
elongation lacquer 	вяжущее вещество
embedded steel 	закладная
embossing board 	картон для тиснения
embossing calender	гофрировальный (филигранный) станок
embossing die (plate) 	штамп для тиснения
emergency stop 	аварийный останов
emergency stop distance	расстояние при аварийном останове
empty pallet infeed 	загрузка пустого поддона
emulsifier 	эмульгатор
enclosed blade chamber 	закрытая ракельная камера
enclosed volume 	рабочий объем
endless belt	бесконечный приводной ремень (сетка)
endurance test	испытание на долговечность
energy consumption	потребление энергии
engraved cells 	гравированные ячейки
engraved cylinder 	гравированный вал
engraving 	вымывание
engraving solvent 	вымывной раствор
engraving stage 	стадия вымывания
enterprise resource planning (ERP)	система планирования ресурсов предприятия
environment control	охрана окружающей среды
equipment 	оборудование
ERP system	интегрированная система
establish of design rule	создание технологических норм
evaporation 	испарение
exact match, best match 	полное совпадение
excess water 	избыток воды
execute 	выполнение
exhaust 	вытяжная вентиляция
expanding chuck 	разжимной патрон
exposed film 	экспонированная пленка
exposed flute packaging 	упаковка «гофрой наружу»
exposure curve 	график экспонирования
extended chain transfer conveyor	удлиненный цепной передаточный транспортер
external preconditioner	внешний узел предварительного кондиционирования
extraction line	линия отвода газов

fabric	сукно, сушильная сетка (ткань)
fabric cleaning	промывка волокон
facer flow scheme for a corrugator	технологическая схема гофропресса гофроагрегата
factory service	вспомогательное производство
fading test	испытание на прочность окраски в свету (на цветопрочность)
failure	дефект
failure analysis	анализ дефектов (брака)
failure products	бракованная продукция
fan	вентилятор
fastening bar	крепежная штанга
fat resistance	жиростойкость
fatigue bending test	испытание на усталочную прочность при многократном изгибе
fault identification	выявление неисправности
feathering	размытые края, растискивание
featherweight (bulking) board	пухлый картон
feed	загрузка
feed belt	подающий ленточный транспортер, загрузочныеролики
feed cable	feed gate
feed gate	система подачи
feed main	подводящая магистраль
feed table	стол подачи
feeder	питатель, самонаклад, стол подачи
feeder with infeed rollers	самонакладе загрузочными роликами
feeder with vacuum transfer	самонаклад с вакуумной системой транспортировки
feeding conveyor	загрузочный транспортер
feeding reel	загруженный рулон
feeding section	секция подачи
feeding table	стол подачи
feedwater	питающая вода
felt	сукно
felt conditioner	сукномойка
felt draw	натяжение сушильных сукон
felt dryer	сушка сукна
felt-drying cylinder	сушильный цилиндр для сукна, сукносушитель
felt guide	правка сукна
felt guide roll	сукноведущий валик
felt stretch	натяжение сукна
felt stretch roll	сукнонатяжной вал
felt suction roll	отсасывающий валик сукна
felt washing machine	сукномойка
felt whipper	сукноочиститель ударного действия
felt-stretching roll	сукнонатяжной валик
felt-through-drying roll	валик Маделен
female	матрица
female creasing	биговка матричной формой
festoon	накопитель, фестонная часть
festoon bridge	накопительный стол
festoon carriage	накопительная каретка
festoon stock	накопительный мостик
fiber	волокно
fiber press	шнек-пресс
fibre bundles	косички целлюлозы
fibre length spectrum	спектр длины волокна
fibre purification	облагораживание волокна
fibre soup	волокнистая масса
fibreboard	картонная тара
fibres	волокна
fibrillation	фибриляция
field instruments	полевые приборы
fill	заливать
fill in	слияние контуров печатных элементов
filled board	картон с внутренними слоями из другого материала
filled news board	многослойный картон с покровными слоями из макулатуры и внутренним из другого материала
filled pulp board	многослойный картон с покровными слоями из целлюлозы и внутренним из другого материала
filled roll	набивной вал
film	пленка
film coating	пленочное мелование
film development	обработка пленки
film handling	обработка пленки
film imaged with laser	пленка, с репродуцированным лазером изображением
film laminated onto the plate	пленка припрессованная на форму
film of ink	слой краски
film press	пленочный пресс
film recorder	выводное устройство, фотонаборный автомат
film removed	удаление пленки
filter	фильтр
filter bag	мешочный фильтр
filter cartridge	фильтрующий картридж
filter cloth cross-section photographs	фильтровальное полотно в разрезе фото
filter unit	фильтр
filtration plant	фильтровальная станция
final output	конечный продукт
finance resource management (FRM)	управление финансовым обеспечением
fine board	высокосортный картон
fine flute	мелкий профиль
fine grey cardboard	высокосортный серый картон
fine screening	тонкое сортирование
fine-mesh sieve	сито с мелкими отверстиями
finest screen	мелкозернистое растрирование
fingerless single facer	гофопресс безгребенчатого типа
fingers	гребни
finished goods area	зона готовой продукции
finished goods storage (warehouse)	склад готовой продукции
finished production	готовые изделия
finished roll	готовый рулон
finished with UVC light	окончательная обработка
finishing	отделка (печатной продукции), обработка
finishing equipment	отделочное оборудование
finishing process	финишинг
finishing reel	заканчивающийся рулон
finishing section	отделочная секция
finishing units	устройство для финишинга
fire damper	противопожарная заслонка
firebox	камера сгорания
fire-resistant board	огнеупорный картон
firewall	система ограничения доступа
first coater head	первая меловальная головка
first generation frequency modulation (FM)	частотно-модулированное (ЧМ) растрирования первого поколения
first generation screen	растрирование первого поколения
first group of cylinders	первая часть цилиндров
first side drying	сушка 1-й стороны
fisheye, pinholes	точечный дефект
five ply corrugator line	линия по производству 5-слойного гофрированного картона
five point profile	пятиточечный профиль
fixed guard	стационарное ограждение
flaking	расслаивание
flank	торец
flap	клапан
flap-cutter	машина для просечки клапанов
flat crush	плоскостное сжатие
flat crush resistance	показатель сопротивления плоскостному сжатию
flat crush test	испытание на плоскостное сжатие
flatbed die cutter	плоская высечка
flatness	спрямление
flatten	разглаживать
flexiblade coater	меловальный шаберный станок
flexible fibres	гибкие волокна
flexible neoprene motive (pressure) duct	гибкая неопреновая трубка (под давлением)
flexible steel discharge duct	гибкий стальной разгрузочный воздуховод
flexible steel intake duct	гибкий стальной загрузочный воздуховод
flexo	флексо
flexo folder gluer	флексофальцесклейка
flexo inking system	системы подачи краски для флексо
flexo machine	флекопечатная машина
flexo press	флексографическая печатная машина
flexographic plate	флексографская печатная форма
flexographic printing (flexography)	флексографская печать
flexo-printer-slotter-folder-gluer	флексовысекально-фальцевально- склеивающая линия
flexural rigidity	несгибаемость
flexural strength 	прочность на изгиб
float steam trap 	поплавковый конденсатоотводчик
float type steam trap	конденсационный горшок поплавкового типа
floating scraper 	шабер маятниковый
floor sweep 	напольный очиститель
floor track 	напольные рельсы
flotation 	флотация
flotator 	флотатор
flow box 	напорный ящик
flow meter 	расходомер
flow sheet	технологическая схема
flowsheet of the stock preparation line for secondary fibre	линии размольно-подготовительного участка для вторичного волокна
flow storage	участок для потокового складирования
flow transmitter 	расходомер
flow unit 	ротаметр
flute 	профиль гофрокартона
flute pitch 	шаг гофрирования
flute tip 	вершины гофры
fluted rolls 	флютинг в рулонах
fluter	гофрообразователь, гофровал
fluting 	флютинг в рулонах
flutting medium 	гофрированный слой
fly press 	винтовой пресс
flywheel 	черпальное колесо

galley	гранки, корректурный оттиск
galley proof	оттиск с гранки
gamma	гамма
gamma correction	гамма изображения с градацией, воспроизводимой выводным устройством
gamut	цветовая гамма, цветовой охват
gas flow direction	направление потока воздуха
gas outlet	выход воздуха
gauge	упор
gear	шестерня
gear motor	мотор-редуктор
gel point	точка клейстеризации
gelatinization	клейстеризация
general-purpose equipment	универсальная испытательная машина
generate P.О.	создание заказа на поставку
glare	блик
glazed	гладкий
glazer	лощильный (фрикционный) каландр
glazing	лощение
glazing cylinder	лощильный цилиндр
glazing press	лощильный пресс
gloss (hot) calender	горячий лощильный каландр (пресс)
gloss (hot) calendering	горячее каландрирование
gloss color	глянцевый цвет
glue	клей
glue applicator roll	клеенаносящий вал
glue bond	клеевое соединение
glue dam	ограничитель клея
glue detection device	система обнаружения клея
glue kitchen	клеевая кухня
glue machine	узел склейки
glue pan	клеевая ванна
glue roll	клеенаносящий вал, клеевой вал
glue section	клеевая кухня
glue station	узел склейки
glue tray	ванна для клея
glue unit	клеевой узел, узел склейки, клеенаносящий станок
glue-bond test	испытание прочности клеевого соединения (клеевой склейки)
glue-coated	натертый клеем
glued (bonded) seal	клеевое уплотнение
gluer storage	участок хранения клея
gluing	склейка
gluing and pressing unit	узел склейки и прессования
gradation	градация
gradient fill	градиентная заливка
grain	зерно, зернистость
grammage	масса, граммаж
granding	заземление
granite roll	гранитный вал
graphic design	графический дизайн
gravure	глубокая печать
gravure unit	секция глубокой печати
grayscale image	полутоновое изображение
grease-proof paper	жиростойкая бумага
greenfield	проект, создаваемый «с нуля»
green field factory	завод «с нуля»
grid	сетка
grid size	шаг координатной сетки
grid snap	привязка к координатной сетке
gridlines	линии сетки
grinding	шлифовка
grinding tool	шлифовальный инструмент
gripper	грейфер
gripper maintanance area	зона обслуживания грейфера
ground wood	древесная масса
group trapping	отвод конденсата с группы
group trapping with different process pressures	отвод конденсата с группы с разным рабочим давлением
group trapping with same process pressures	отвод конденсата с группы с одинаковым рабочим давлением
guard bars	сетка штрихкода
guide mark	приводочная метка
guide rod	направляющая штанга, бумаговедущий вал, направляющий вал
guide wire	проводник
guide wire detection sensor	проводник опознавательного устройства
gummosity of cellulose	смолистость целлюлозы

hairline register	точная приводка
halftone	полутон, растр
halftone cell	растровая ячейка
halftone dot	растровая точка
halftone frequency	линиатура растра
halftone gradation	градация растрового изображения
halftone image	растровое изображение
halftone negative	растровый негатив
halftone period	период растра
halftone screen	растр
halftoning factor	коэффициент качества
halo	венчик, ореол
halo effect round blocks	эффект ореола вокруг печатного изображения
handling	упаковка
handling equipment	транспортные системы
hangup	развешивать
hard copy proof	оттиск с изображением на бумаге
hardcopy imposition proof	утверждение раскроя на бумаге
hardness	жесткость, твердость
hardness of rolls	плотность намотки
hard-sized	сильно проклеенный
hardwood fibres	волокна лиственной древесины
hardwood pulp	лиственная целлюлоза
harsh handle	шершавый (грубый) на ощупь
harvest	заготовка
head box	напорный ящик
head lift direction	направление подъема головки
header	головка, потокораспределитель, коллектор
header press	пресс для приклеивания боковых крышек
headroom	габаритная высота
heat conduction, thermo conduction	теплопроводимость
heat effect	воздействие тепла
heat exchanger	теплоообменник
heat recovery	теплорекуперация
heat resistance	теплостойкость
heat seal	термосварка
heated dryer	горячая сушка
heated infeed plate	нагреваемая плита на входе
heating cylinder 	подогревательный цилиндр
heating section 	узел нагрева
heating steam 	греющий пар
heating unit 	узел подогрева
heating vessels 	нагреваемые сосуды
heating zone 	зона нагрева
heavy coated kraftliner (coat plus)	крафтлайнер с плотным меловальным слоем (покрытие +)
heavy coated layer 	плотный меловальный слой
heavy contaminants 	тяжелые отходы
heavy shadows 	глубокие тени
height of suction 	высота всасывания
hidden line 	невидимая линия
hidden line removal 	удаление невидимых линий
hidden surface 	невидимая поверхность
hidden-line wireframe 	каркас со скрытыми ребрами
hidden-surface removal 	удаление невидимых поверхностей
high bay store 	многоярусный склад
high consistency 	высокая концентрация
high consistency cleaner 	очиститель высокой концентрации
high dynamic range (HDR) 	расширенный динамический диапазон
high gloss 	высокий лоск (глянец)
high pressure condensate return 	линия возврата конденсата высокого давления
high pressure steam 	пар высокого давления
high quality 	высококачественный
high-duty 	высокопроизводительный
high-lift truck 	штабелер
highlight 	светлый тон
highlight contrast 	контраст «высоких цветов»
highlight control 	управление градацией «высоких цветов»
hitch roll 	натяжной валик
hoist 	подъемник
holding system 	поддерживающая система
hollow 	выемка, высота рельефа
hollow engraved cylinder 	гравированный вал
hood 	колпак
hooper 	загрузочная воронка, приемный желоб
horizontal baler 	упаковочный пресс горизонтального типа
horizontal web path 	горизонтальная проводка полотна
hot banking heater 	объединенный нагреватель
hot melt 	термоклей
hot plate section 	секция нагревательных плит
hot plate section 	сушильная секция
hot plate (hotplate)	нагревательная плита
hot well 	конденсатосборник
house color 	фирменный цвет
house style 	внутренний стиль
housing 	кожух
high pressure steam from boiler	пар высокого давления из котла
hue 	насыщенность цвета
hue on the substrate 	оттенок на запечатываемом материале
human resource management (HRM)	управление персоналом
humid air bleed with flow 	выводимый поток влажного воздуха
humidity 	влажность
humidity resistance 	влагостойкость
hybrid screening 	гибридное растрирование
hybrid screening example in the highlights 	гибридное растрирование в светлых тонах
hybrid typeface 	гибридный шрифт
hydration 	гидратация
hydraulic cylinder 	гидравлический цилиндр
hydraulic power unit 	гидростанция
hydraulic system 	гидравлическая система
hydrophobic contaminants 	гидрофобные примеси
